 
 ┌─┐  ┌─┐
┌┼─┴──┴─┼┐
││ ░══░ ││
│└══╦╦══┘│
│┌──╚╝──┐│
││  📱  ││
│└──────┘│
└────────┘

