
   o
   I                      o
o /I                      H
I/ I______,'_._"_-,-___o__H
I /   ,Z           .|  H /H
I/____E-_-"k_      P___H/ H
I_________\       /____H
I         (=_-*+*"     H
